Watch out, the ice is slippery!
40
..............................
......W.....W....W.......W....
.....III................iii...
...........III..III...........
.....1..................X.....
...iiiiii............iiiiii...
..............................
.....W.W.W..........W.W.W.....
...iiIIIII..........IIIIIii...
..............................
.....W.W.W..........W.W.W.....
....iiiiiii........iiiiiii....
..............................
........W.W........W.W........
..II....IIII......IIII....II..