Use the turtle to jump higher, but watch out!
50
....................
................W...
..W............III..
.###.....WE.........
.........##.........
....................
RF.W.W.W.......W.W.W
iiiiiiii............
.............---....
....................
........---.......X.
................----
........C...........
......-------.......
................W..R
...............hh...
W..T..........W.....
hhlhh.........hh....
.1..............W...
#######......iiiii..