Red tiles are hot: they'll make you explode faster!
50
........W...W.......
..X...W...W...W.F..R
##HHHHHHHHHHHHHHHH..
.......W...W...W....
R..F.W...W...W...W..
..HHHHHHHHHHHHHHHH##
........W...W.......
..W...W...W...W.F..R
##HHHHHHHHHHHHHHHH..
.......W...W...W....
R..F.W...W...W...W..
..HHHHHHHHHHHHHHHH##
....W...W...W.......
..W...W...W...W.F..R
####HHHHHHHHHHHHHH..
.......W...W...W....
R..F.W...W...W...W..
..HHHHHHHHHHHHHHHH##
....W...W...W.......
..W...W...W...W.F..R
##HHHHHHHHHHHHHHHH..
.......W...W...W....
R..F.W...W...W...W..
..HHHHHHHHHHHHHHHH##
...W...W...W...W....
.W...W...W...W....1.
####################