Many, many, many, many, many rockets...
30
....................
R..W...........X....
...--..W.......--...
....W.--........W..R
...--..........--...
R..W......W....W....
...--....--....--...
....W...........W...
...--........W.--...
R..W........--.W....
...--..........--...
....W...........W..R
...--..........--...
.1.......FE.........
######..####..######