Red tiles are hot: they'll make you explode faster!
........W...W.......
.X....W...W...W....R
####FHFHFHFHFHFHFH..
.......W...W...W....
R....W...W...W...W..
..HFHFHFHFHFHFHFHF##
....W...W...W.......
..W...W...W...W....R
##FHFHFHFHFHFHFHFH..
.......W...W...W....
R....W...W...W...W..
..HFHFHFHFHFHFHFHF##
...W...W...W...W....
.W...W...W...W....1.
####################