When Sparky drops down, better get out of the way.
60
...........................
........W.W.W.X.W.W.W......
........-------------......
...........................
..C...W.W.W.W.W.W.W.W.W.C..
..-----------------------..
.W.......................W.
---.W...S....W....S...W.---
....-...-....-....-...-....
...........................
....W.....W.....W.....W....
---...---...---...---...---
...........................
.1.....S.....W.....S.....W.
###...#V#...###...#V#...###